111111111
1010C00C1
1010C0C11
10C0100E1
111111111