111111111
1P10C00C1
1010C0C11
10C0100E1
111111111