1111111111
1P010001C1
1011010101
1000C100E1
1111111111