111111111
1P1000111
101101C11
100010101
111111111