1111111111
1P010001C1
1011010101
100001C0E1
1111111111