11111111111111111
1000100000000C001
10011000000011111
10001110000000001
10001E00011111111
10000000000000001
10010C000000000C1
10010P00000111111
1C0100001000000C1
11111111111111111