11111111111111111
10001000000000001
100010000P0000001
10001000000000001
10001000011111111
1000000C000000001
10000000000000001
10000000000111111
100000001000000E1
11111111111111111