11111111111111111
100P1000000000001
10011000000011111
10001000000000001
10001000100000001
10000000100000001
10010000100000001
10010000100111111
100100001000E0001
11111111111111111
