11111111111111111
1C0P100000000C001
10011111111011111
10011000001000001
10011000101000001
10011000101000001
10011C001010000C1
10011111101111111
1C0100001000E00C1
11111111111111111
