11111111111111111
1C0P100000000C001
10011000000011111
10001000000000001
10001000100000001
10000000100000001
10010C001000000C1
10010000100111111
1C01P0001000E00C1
11111111111111111
